{
  "parameters": {
    "geography": "us",
    "format": "json",
    "api-version": "1.0"
  },
  "responses": {
    "200": {
      "body": {
        "poiCategories": [
          {
            "id": 7320,
            "name": "Sports Center",
            "childCategoryIds": [
              7320002,
              7320003,
              7320005
            ],
            "synonyms": [
              "Gym",
              "Indoors Sports",
              "Sports Centre"
            ]
          },
          {
            "id": 7374,
            "name": "Stadium",
            "childCategoryIds": [
              7374002,
              7374009,
              7374012,
              7374003,
              7374010,
              7374005,
              7374008,
              7374011,
              7374006,
              7374014,
              7374013,
              7374007,
              7374004
            ],
            "synonyms": [
              "Arena",
              "Gymnasium",
              "Sports Ground",
              "Sports Stadium"
            ]
          },
          {
            "id": 7315,
            "name": "Restaurant",
            "childCategoryIds": [
              7315081,
              7315002,
              7315082,
              7315003,
              7315083,
              7315084,
              7315085,
              7315062,
              7315086,
              7315004,
              7315146,
              7315005,
              7315087,
              7315006,
              7315007,
              7315088,
              7315089,
              7315072,
              7315008,
              7315142,
              7315090,
              7315091,
              7315147,
              7315009,
              7315092,
              7315010,
              7315011,
              7315070,
              7315093,
              7315012,
              7315094,
              7315095,
              7315063,
              7315013,
              7315096,
              7315097,
              7315068,
              7315098,
              7315099,
              7315057,
              7315079,
              7315014,
              7315100,
              7315101,
              7315132,
              7315102,
              7315133,
              7315015,
              7315016,
              7315104,
              7315134,
              7315017,
              7315071,
              7315018,
              7315019,
              7315020,
              7315054,
              7315069,
              7315021,
              7315058,
              7315052,
              7315022,
              7315078,
              7315023,
              7315024,
              7315073,
              7315105,
              7315065,
              7315106,
              7315025,
              7315066,
              7315026,
              7315027,
              7315028,
              7315067,
              7315029,
              7315030,
              7315107,
              7315135,
              7315108,
              7315031,
              7315109,
              7315032,
              7315033,
              7315034,
              7315110,
              7315074,
              7315136,
              7315111,
              7315112,
              7315075,
              7315035,
              7315127,
              7315061,
              7315036,
              7315037,
              7315129,
              7315038,
              7315130,
              7315039,
              7315041,
              7315131,
              7315040,
              7315143,
              7315042,
              7315113,
              7315114,
              7315115,
              7315043,
              7315053,
              7315055,
              7315056,
              7315116,
              7315117,
              7315080,
              7315139,
              7315064,
              7315140,
              7315044,
              7315045,
              7315118,
              7315046,
              7315148,
              7315119,
              7315047,
              7315120,
              7315059,
              7315145,
              7315076,
              7315121,
              7315048,
              7315122,
              7315123,
              7315049,
              7315124,
              7315050,
              7315125,
              7315051,
              7315126,
              7315060,
              7315149
            ],
            "synonyms": [
              "Dining",
              "Eatery",
              "Eating House",
              "Eating Place"
            ]
          }
        ]
      }
    }
  }
}
